1111111111111111111111111111111111111111
1E0000000000000C00000C000000000001C00001
1010010100100000101001000000010101000001
101001001010101000100100000001010000C001
1P0000000C00C0000000000000000000C0000001
101001001010101000100100000001010000C001
100000000C00C0000000000000000000C0000001
101001001010101000100100000001010000C001
100000000C00C0000000000000000000C0000001
101001001010101000100100000001010000C001
100CC00001001000000000000000000010000001
1010010010101010001001000000010100001001
1000000001001000000000000000000010000001
1010010010101010001001000000010100001001
1010010010101010001001000000010100001001
1010010010101010001001000000010100001001
1010010010101010001001000000010100001001
1010010010101010001001000000010100001001
1010010010101010001001000000010100001001
1111111111111111111111111111111111111111