111111111111111111111111111111111111111111111111111111111111111111111111111
11P0000000000000000000C0000000000000000010000000000000000000000000000000001
111111111111111111111111111111100000000010000000000000000000000000E00000001
10000000000000000000000C000000000000000010000000000000000000000000000000001
100000000000000000000000000000000000000010000000000000000000000000000000001
100000000000000000000000000011111111111110000000000000000000000000000000001
1000000C0000000000000000000011000000000000000000000000001000000000000000001
10000000000000000000000000011100000000000000000000000001C000000000000000011
100000000000000000000000000111000000000000000000000000000000000000000000001
100000000000000000000000000001000000000000000000000000000000000000000000001
1000000000000C0000000000000000000000000000000000C00000000000000000000000001
100000000000000000000000000000000000000000000000000000000000000000000000001
111111111111111111111111111111111111111111111111111111111111111111111111111