111111111111111111111111111111111111111111111111
10000000000000000000000000000000000000000001C1E1
100000000000000000000000000000000000000000011101
100000000000000000000000000000000000000000000001
100000000000000000000000000000000000000000000001
100000000000000000000000000000000000000000000001
100000000000000000000000000000000000000000000001
11P000000000000000000000000000000000000000000001
111111111111111111111111111111111111111111111111