1111111111111
10010000000C1
1000011110011
1000011110011
1000011110011
10000000C0011
1P0011E000001
1111111111111