111111111111
111CEC000111
1000C0000011
110111111111
1CCCCCCCCCP1
111111111111